0 0 0 0 0 0 0 0 0 0 0 0 0 0 0 0
0 4 4 4 4 4 4 4 4 4 4 4 4 4 4 0
0 7 3 3 3 2 3 3 3 3 3 3 3 3 7 0
0 7 3 3 3 2 3 3 3 3 3 3 3 3 7 0
0 7 3 3 3 7 7 7 7 7 7 3 3 3 7 0
0 7 3 3 3 7 0 0 0 0 7 3 3 3 7 0
0 7 3 3 3 7 0 0 0 0 7 3 3 3 7 0
0 7 3 3 3 7 7 7 7 7 7 3 3 3 7 0
0 7 3 3 3 3 3 3 3 3 3 3 3 3 7 0
0 7 3 3 3 3 3 3 3 3 3 3 3 3 7 0
0 5 5 5 5 5 5 5 5 5 5 5 5 5 5 0
0 0 0 0 0 0 0 0 0 0 0 0 0 0 0 0
